0,3,3,3,3,3,3,3,3,3,3,3,3,3,0
0,3,14,3,2,2,2,2,2,2,2,2,3,3,0
0,3,2,3,2,2,2,11,2,2,2,2,3,3,0
0,3,2,2,6,2,2,12,2,2,12,2,2,3,0
0,3,3,2,2,2,2,2,2,7,12,2,2,3,0
0,3,3,2,2,2,2,2,2,2,12,2,3,3,0
0,3,3,9,2,2,2,2,2,2,2,2,3,3,0
0,3,3,3,3,3,3,2,3,3,3,3,3,3,0
0,3,2,2,2,3,3,2,3,3,3,3,3,3,0
0,3,2,12,9,2,2,2,2,2,11,3,3,3,0
0,3,2,2,3,3,3,2,3,3,2,3,3,3,0
0,3,3,2,3,3,3,2,3,3,2,3,3,3,0
0,3,3,2,3,3,3,2,2,2,2,3,3,3,0
0,3,1,2,2,2,2,2,3,3,3,3,3,3,0
0,3,3,3,3,3,3,3,3,3,3,3,3,3,0
