0,3,3,3,3,3,3,3,3,0
0,3,3,3,3,2,3,3,3,0
0,3,3,3,3,2,3,3,3,0
0,3,3,3,3,2,3,3,3,0
0,3,3,3,3,2,2,11,3,0
0,3,3,3,3,2,3,2,3,0
0,3,3,3,3,1,2,2,3,0
0,3,3,3,3,3,3,3,3,0
0,0,0,0,0,0,0,0,0,0
