0,3,3,3,3,3,3,3,3,0
0,3,3,3,3,3,3,14,3,0
0,3,2,2,2,2,2,2,3,0
0,3,2,3,3,3,2,8,3,0
0,3,2,3,3,3,3,3,3,0
0,3,2,3,3,2,2,2,3,0
0,3,2,2,2,4,3,2,3,0
0,3,3,3,3,2,3,2,3,0
0,3,3,3,3,1,2,2,3,0
0,3,3,3,3,3,3,3,3,0
