0,3,3,3,3,3,3,3,3,0
0,3,14,3,3,3,3,3,3,0
0,3,2,3,2,2,2,2,3,0
0,3,2,2,6,3,3,2,3,0
0,3,3,3,2,3,3,2,3,0
0,3,3,3,2,2,2,2,3,0
0,3,3,3,2,3,3,3,3,0
0,3,3,3,1,3,3,3,3,0
0,3,3,3,3,3,3,3,3,0
